,Player,Career Start,Career End,Col Games Played,Col MP,Col FG,Col FGA,Col 2P,Col 2PA,Col 3P,Col 3PA,Col FT,Col FTA,Col ORB,Col DRB,Col TRB,Col AST,Col STL,Col BLK,Col TOV,Col PTS,player_id
0,A.J. English,2013,2016,95,3484,572,1349,288,584,284,765,457,574,63,382,445,488,126,46,321,1885,10263
1,Aaron Brooks,2006,2007,35,1289,213,463,133,265,80,198,115,136,31,118,149,149,48,6,89,621,9575
2,Aaron Harrison,2013,2014,40,1303,174,411,112,237,62,174,139,176,25,93,118,74,43,12,65,549,10767
3,Acie Law,2006,2007,34,1153,216,432,178,349,38,83,144,185,8,105,113,169,39,1,88,614,11442
4,Adam Morrison,2004,2006,64,2264,532,1071,421,779,111,292,340,443,90,263,353,144,54,25,128,1515,11940
5,Al Thornton,2006,2007,35,1092,244,460,208,379,36,81,166,210,106,145,251,24,53,40,87,690,13117
6,Alan Williams,2013,2014,28,872,224,420,224,420,0,0,148,216,106,216,322,33,33,67,59,596,13453
7,Alando Tucker,2005,2007,67,2215,478,1035,421,844,57,191,291,482,153,220,373,126,52,17,123,1304,13173
8,Alec Burks,2010,2011,38,1193,251,535,223,439,28,96,249,302,91,156,247,112,41,12,99,779,9656
9,Alec Peters,2014,2017,100,3244,636,1309,404,764,232,545,411,478,231,601,832,155,73,33,183,1915,12277
10,Allan Ray,2003,2006,67,2242,389,941,195,431,194,510,226,270,40,210,250,152,70,10,148,1198,12425
11,Allen Crabbe,2012,2013,33,1195,215,468,151,284,64,184,113,139,33,167,200,87,37,23,83,607,9921
12,Andre Emmett,2001,2004,100,3565,799,1555,763,1444,36,111,407,574,224,439,663,173,148,39,202,2041,10259
13,Andre Owens,2004,2005,32,1114,195,485,95,205,100,280,95,132,46,109,155,67,42,5,61,585,12170
14,Andrew Bogut,2004,2005,35,1224,281,453,272,428,9,25,144,208,130,297,427,82,34,65,96,715,9467
15,Andrew Goudelock,2008,2011,107,3632,789,1734,466,949,323,785,236,283,68,313,381,355,97,31,256,2137,10560
16,Andrew Nicholson,2010,2012,63,2011,457,800,428,724,29,76,293,397,135,359,494,65,38,108,179,1236,12057
17,Andrew Wiggins,2013,2014,35,1148,189,422,146,296,43,126,176,227,76,129,205,54,41,34,80,597,13429
18,Anthony Bennett,2012,2013,35,950,202,379,166,283,36,96,124,177,86,199,285,34,24,43,65,564,9390
19,Anthony Brown,2014,2015,37,1320,176,408,97,229,79,179,116,146,42,214,256,94,28,7,72,547,9582
20,Anthony Davis,2011,2012,40,1281,210,337,207,317,3,20,144,203,119,296,415,50,54,186,41,567,10002
21,Anthony Grundy,2001,2002,34,1102,219,451,172,315,47,136,121,158,53,133,186,120,70,5,75,606,10652
22,Anthony Johnson,2009,2010,66,2155,392,778,347,674,45,104,332,438,180,256,436,112,65,86,152,1161,11091
23,Anthony Roberson,2003,2005,60,1888,373,813,180,338,193,475,160,182,30,124,154,185,56,6,122,1099,12507
24,Antoine Wright,2004,2005,31,1052,193,385,122,226,71,159,96,139,51,134,185,69,36,22,75,553,13592
25,Antonius Cleveland,2016,2017,33,1086,208,383,180,310,28,73,105,159,28,141,169,73,47,30,66,549,9825
26,Arron Afflalo,2005,2007,75,2489,413,895,243,436,170,459,230,286,47,216,263,139,46,13,143,1226,9127
27,Ben Bentil,2015,2016,35,1198,246,533,194,375,52,158,194,248,94,174,268,40,30,36,67,738,9400
28,Ben Gordon,2002,2004,72,2447,450,1027,266,596,184,431,284,347,63,259,322,332,91,13,221,1368,10553
29,Ben Hansbrough,2010,2011,34,1202,194,405,107,205,87,200,150,184,25,106,131,145,41,4,81,625,10716
30,Ben McLemore,2012,2013,37,1191,198,400,125,226,73,174,120,138,47,145,192,73,37,25,77,589,11777
31,Ben Simmons,2015,2016,33,1151,216,386,215,383,1,3,199,297,103,285,388,158,65,27,111,632,12783
32,Ben Uzoh,2007,2008,39,1258,208,426,153,269,55,157,137,170,64,148,212,88,39,29,92,608,13211
33,Blake Griffin,2008,2009,35,1165,300,459,297,451,3,8,191,324,135,369,504,80,39,41,116,794,10637
34,Bobby Brown,2004,2007,59,2082,381,868,216,418,165,450,157,195,27,128,155,287,77,6,201,1084,9584
35,Bobby Portis,2014,2015,36,1076,250,466,236,436,14,30,115,156,133,188,321,42,39,50,56,629,12340
36,Bradley Beal,2011,2012,37,1267,175,393,112,207,63,186,133,173,50,199,249,83,51,31,79,546,9353
37,Brandan Wright,2006,2007,37,1013,228,353,228,353,0,0,89,157,77,152,229,37,36,65,59,545,13595
38,Brandin Knight,2001,2002,35,1284,194,454,101,193,93,261,65,147,27,140,167,251,82,16,112,546,11335
39,Brandon Armstrong,2000,2001,31,1027,240,537,164,339,76,198,128,155,36,65,101,46,46,6,65,684,9226
40,Brandon Davies,2012,2013,36,1054,229,439,224,425,5,14,174,255,74,213,287,88,48,35,92,637,10001
41,Brandon Hunter,2000,2003,60,2134,398,770,384,724,14,46,377,606,176,484,660,158,48,50,225,1187,10969
42,Brandon Ingram,2015,2016,36,1246,214,484,134,289,80,195,116,170,67,177,244,72,41,49,72,624,10996
43,Brandon Knight,2010,2011,38,1363,217,513,130,282,87,231,136,171,25,128,153,159,25,8,120,657,11336
44,Brandon Paul,2012,2013,36,1153,184,459,106,219,78,240,152,206,22,135,157,98,44,23,96,598,12231
45,Brandon Roy,2005,2006,33,1046,228,449,189,352,39,97,171,211,69,117,186,135,46,26,75,666,12592
46,Brian Cook,2002,2003,30,940,202,422,175,333,27,89,168,205,44,183,227,60,20,13,83,599,9879
47,Brian Roberts,2006,2008,65,2282,387,823,205,424,182,399,244,277,14,171,185,199,34,11,166,1200,12512
48,Brice Johnson,2015,2016,40,1121,267,435,267,435,0,0,144,184,115,301,416,58,43,59,71,678,11095
49,Bryce Cotton,2012,2014,67,2607,425,995,250,516,175,479,368,443,42,197,239,297,65,6,132,1393,9906
50,Buddy Hield,2013,2016,105,3503,702,1539,372,725,330,814,346,414,160,388,548,204,135,31,241,2080,10855
51,C.J. McCollum,2009,2012,99,3285,671,1552,487,1040,184,512,548,666,155,481,636,269,211,47,235,2074,11719
52,C.J. Wilcox,2012,2014,66,2300,398,915,233,480,165,435,196,232,62,203,265,146,69,68,117,1157,13432
53,Caleb Swanigan,2016,2017,35,1139,222,421,184,336,38,85,164,210,96,340,436,107,15,28,118,646,13009
54,Cameron Bairstow,2013,2014,34,1119,237,426,236,423,1,3,219,298,76,175,251,53,19,51,68,694,9273
55,Cameron Payne,2013,2015,69,2238,435,1007,279,573,156,434,253,324,31,221,252,394,125,37,197,1279,12242
56,Carl Landry,2006,2007,34,1035,219,367,215,348,4,19,201,277,101,148,249,42,40,32,102,643,11414
57,Carlos Arroyo,2000,2001,29,1113,215,499,163,323,52,176,134,180,24,76,100,117,51,6,107,616,9234
58,Carlos Boozer,2001,2002,35,993,230,346,230,345,0,1,178,236,119,184,303,38,31,21,65,638,9489
59,Carmelo Anthony,2002,2003,35,1274,277,612,221,446,56,166,168,238,101,248,349,77,55,30,77,778,9208
60,Caron Butler,2001,2002,34,1223,253,521,223,446,30,75,155,199,108,148,256,101,71,13,98,691,9675
61,Cartier Martin,2006,2007,35,963,197,428,119,226,78,202,127,159,69,86,155,45,24,8,58,599,11652
62,Casey Jacobsen,2000,2002,64,2137,408,865,260,515,148,350,310,392,73,198,271,184,36,6,138,1274,11043
63,Casper Ware,2010,2012,68,2333,361,879,192,418,169,461,285,355,29,137,166,264,102,9,183,1176,13317
64,Channing Frye,2004,2005,37,1148,227,410,224,393,3,17,127,153,104,178,282,72,35,85,64,584,10425
65,Charles Jenkins,2008,2011,99,3588,687,1516,527,1106,160,410,543,665,84,334,418,429,164,56,288,2077,11075
66,Charles Williams,2017,2019,66,2200,462,1036,328,694,134,342,205,250,45,157,202,42,50,19,107,1263,13461
67,Chase Budinger,2007,2009,69,2517,423,913,283,553,140,360,227,298,83,318,401,217,88,22,165,1213,9641
68,Chasson Randle,2013,2015,73,2610,435,999,277,576,158,423,371,451,31,221,252,189,87,7,163,1399,12409
69,Chris Douglas-Roberts,2006,2008,75,2077,453,836,389,669,64,167,292,405,90,195,285,132,88,34,149,1262,10142
70,Chris Harris,2009,2010,30,1047,183,512,95,255,88,257,178,204,8,67,75,56,60,3,88,632,10755
71,Chris Kaman,2002,2003,31,1055,244,392,244,392,0,0,206,275,112,261,373,37,19,98,137,694,11235
72,Cleanthony Early,2012,2014,75,1965,371,790,258,465,113,325,280,342,137,288,425,50,58,63,131,1135,10201
73,Cody Zeller,2011,2013,72,2087,399,674,399,672,0,2,359,475,188,337,525,92,86,87,141,1157,13633
74,Cory Higgins,2008,2011,100,3404,558,1190,458,905,100,285,519,616,69,342,411,247,156,36,239,1735,10857
75,Courtney Lee,2007,2008,36,1079,259,543,190,369,69,174,148,180,48,127,175,75,65,28,84,735,11458
76,Craig Brackins,2008,2009,32,1041,243,512,222,438,21,74,138,198,55,248,303,43,17,30,74,645,9519
77,Craig Smith,2002,2006,101,3411,719,1249,708,1203,11,46,377,594,295,573,868,196,122,87,228,1826,12839
78,D'Angelo Russell,2014,2015,35,1188,231,515,136,284,95,231,118,156,35,163,198,175,55,11,102,675,12618
79,D.J. Augustin,2007,2008,38,1417,242,551,168,357,74,194,173,221,20,92,112,219,47,0,105,731,9247
80,D.J. White,2007,2008,33,1105,216,357,215,354,1,3,142,206,100,241,341,25,26,54,63,575,13400
81,Dahntay Jones,2002,2003,33,1014,198,421,151,303,47,118,140,187,46,134,180,29,38,18,63,583,11170
82,Dajuan Wagner,2001,2002,36,1146,265,647,199,439,66,208,166,230,18,71,89,128,43,20,105,762,13272
83,Damian Lillard,2009,2012,63,2167,416,924,238,480,178,444,391,448,28,258,286,240,82,11,148,1401,11508
84,Damion James,2008,2010,69,2063,413,853,349,673,64,180,261,385,210,462,672,80,91,70,148,1151,11049
85,Damone Brown,2000,2001,34,1242,215,437,211,423,4,14,125,158,109,191,300,56,58,48,69,559,9586
86,Damyean Dotson,2016,2017,32,1098,202,430,94,186,108,244,44,53,49,173,222,36,29,5,33,556,10135
87,Dan Dickau,2001,2002,32,1110,195,442,78,186,117,256,165,191,15,80,95,149,26,4,92,672,10092
88,Danny Granger,2004,2005,30,900,183,349,138,245,45,104,154,204,69,197,266,71,63,60,72,565,10575
89,Dante Cunningham,2008,2009,38,1199,244,465,244,463,0,2,124,178,99,185,284,47,47,47,82,612,9955
90,Danuel House,2015,2016,36,1114,185,467,110,224,75,243,118,165,39,132,171,77,19,11,64,563,10936
91,Darington Hobson,2009,2010,35,1175,193,439,154,331,39,108,130,199,74,250,324,160,44,15,104,555,10885
92,Darius Johnson-Odom,2010,2012,71,2229,406,923,258,528,148,395,247,336,40,191,231,181,63,11,155,1207,11153
93,Darius Songaila,2001,2002,34,1036,204,390,198,374,6,16,193,226,76,200,276,89,45,27,119,607,12901
94,Darius Washington,2004,2005,38,1334,193,420,146,301,47,119,151,206,37,101,138,144,63,3,134,584,13330
95,David West,2001,2003,64,2262,409,781,391,727,18,54,394,497,191,500,691,152,80,132,184,1230,13383
96,De'Aaron Fox,2016,2017,36,1064,214,447,197,378,17,69,156,212,21,122,143,165,53,7,87,601,10397
97,DeJuan Blair,2008,2009,35,955,226,381,226,381,0,0,98,162,195,237,432,42,54,34,44,550,9442
98,DeMarcus Cousins,2009,2010,38,893,206,369,205,363,1,6,162,268,154,220,374,38,37,67,78,575,9914
99,DeMarre Carroll,2008,2009,38,1064,246,441,230,397,16,44,121,191,92,181,273,82,59,25,56,629,9737
100,Dejounte Murray,2015,2016,34,1139,202,486,168,368,34,118,110,166,48,155,203,151,62,10,110,548,11983
101,Delonte West,2003,2004,32,1073,212,416,156,280,56,136,124,139,38,134,172,151,55,6,82,604,13384
102,Demetris Nichols,2006,2007,35,1217,225,503,125,263,100,240,113,133,50,140,190,54,49,37,77,663,12055
103,Demetrius Jackson,2015,2016,35,1259,193,428,139,265,54,163,113,139,31,90,121,164,43,10,76,553,11016
104,Denzel Valentine,2014,2016,70,2317,402,889,196,410,206,479,152,181,71,407,478,408,67,16,177,1162,13215
105,Derrick Byars,2006,2007,34,1068,206,451,127,239,79,212,86,121,52,113,165,116,48,4,80,577,9683
106,Derrick Rose,2007,2008,40,1168,208,436,173,332,35,104,146,205,54,127,181,189,48,15,107,597,12571
107,Derrick Walton,2016,2017,38,1323,171,392,73,160,98,232,149,170,17,165,182,189,43,1,66,589,13309
108,Derrick White,2016,2017,34,1116,205,404,148,260,57,144,148,182,35,104,139,148,42,49,81,615,13401
109,Derrick Williams,2010,2011,38,1141,226,380,184,306,42,74,247,331,105,209,314,43,37,26,100,741,13467
110,Desmon Farmer,2002,2004,58,1965,352,891,206,447,146,444,256,322,100,171,271,105,61,6,138,1106,10303
111,Devin Brown,2000,2001,28,906,186,436,141,279,45,157,139,193,62,150,212,71,47,9,88,556,9591
112,Devin Harris,2003,2004,32,1162,189,412,114,211,75,201,171,216,20,119,139,141,56,4,66,624,10756
113,Diante Garrett,2010,2011,32,1175,214,518,155,333,59,185,66,80,12,107,119,195,55,7,106,553,10475
114,Dillon Brooks,2015,2017,73,2133,437,914,332,630,105,284,220,281,112,207,319,214,78,31,161,1199,9576
115,Dionte Christmas,2006,2009,98,3486,620,1417,321,611,299,806,393,494,106,419,525,246,138,23,267,1932,9803
116,Domantas Sabonis,2015,2016,36,1149,239,391,234,377,5,14,150,195,110,316,426,64,22,31,92,633,12625
117,Dominique Jones,2008,2010,64,2385,415,954,309,612,106,342,330,453,98,276,374,242,97,31,179,1266,11175
118,Donald Sloan,2009,2010,34,1130,200,450,153,321,47,129,157,204,23,99,122,79,22,2,80,604,12820
119,Donte Greene,2007,2008,35,1253,218,521,128,260,90,261,94,133,60,191,251,71,45,57,91,620,10624
120,Doron Lamb,2011,2012,40,1249,175,369,99,206,76,163,123,149,15,93,108,60,19,2,44,549,11407
121,Doug McDermott,2010,2014,145,4569,1141,2075,867,1477,274,598,594,715,281,807,1088,194,34,14,321,3150,11736
122,Draymond Green,2011,2012,37,1229,212,472,160,338,52,134,125,173,79,315,394,141,54,35,112,601,10604
123,Drew Gooden,2001,2002,37,1119,285,566,275,530,10,36,154,204,126,297,423,73,65,53,108,734,10547
124,Dwayne Bacon,2016,2017,35,1008,221,489,164,318,57,171,104,138,35,112,147,61,35,4,71,603,9263
125,Dwyane Wade,2001,2003,65,1993,474,959,442,863,32,96,301,404,141,279,420,255,150,79,203,1281,13268
126,E'Twaun Moore,2009,2011,69,2255,433,970,312,649,121,321,200,278,83,226,309,201,92,28,134,1187,11914
127,Edwin Ubiles,2007,2008,34,1130,231,439,197,358,34,81,81,115,47,101,148,57,41,33,55,577,13201
128,Elfrid Payton,2013,2014,35,1258,237,466,223,412,14,54,184,302,81,129,210,208,80,21,127,672,12245
129,Elijah Millsap,2009,2010,34,1124,182,418,163,339,19,79,164,236,92,232,324,60,56,11,118,547,11870
130,Elliot Williams,2009,2010,34,1133,178,388,118,224,60,164,194,256,25,110,135,128,45,4,100,610,13470
131,Elston Turner,2012,2013,32,1139,199,467,125,262,74,205,89,105,14,82,96,74,31,7,59,561,13183
132,Emeka Okafor,2003,2004,36,1166,261,436,261,436,0,0,113,218,138,277,415,36,36,147,84,635,12133
133,Eric Gordon,2007,2008,32,1110,184,425,114,217,70,208,231,277,23,81,104,78,42,20,115,669,10555
134,Eric Maynor,2007,2009,66,2321,444,963,328,653,116,310,329,415,40,216,256,385,98,13,197,1333,11692
135,Eric Williams,2005,2006,34,1107,223,360,223,360,0,0,109,221,107,194,301,34,44,37,77,555,13471
136,Erick Green,2012,2013,32,1166,261,550,200,393,61,157,218,267,15,112,127,121,42,6,69,801,10605
137,Evan Turner,2008,2010,64,2310,430,841,399,761,31,80,313,405,118,400,518,316,112,55,253,1204,13184
138,Francisco Garcia,2004,2005,38,1211,187,428,116,234,71,194,150,171,45,113,158,148,65,56,104,595,10457
139,Frank Kaminsky,2014,2015,39,1311,267,488,225,387,42,101,156,200,58,262,320,103,33,57,63,732,11236
140,Frank Mason,2016,2017,36,1301,241,492,159,318,82,174,189,238,22,128,150,187,47,2,86,753,11671
141,Frank Williams,2001,2002,35,1135,174,443,120,284,54,159,164,203,32,131,163,153,71,10,96,566,13473
142,Fred Jones,2001,2002,35,1103,215,413,164,276,51,137,169,194,65,124,189,111,63,18,82,650,11182
143,Gary Forbes,2007,2008,36,1214,233,572,176,377,57,195,175,243,65,205,270,109,41,25,113,698,10370
144,Gary Harris,2013,2014,35,1131,195,455,114,225,81,230,115,142,37,103,140,94,63,15,60,586,10758
145,Gary Neal,2002,2007,61,2097,436,1022,257,514,179,508,299,361,62,195,257,158,64,6,137,1350,12025
146,George Hill,2005,2008,61,2198,395,742,330,583,65,159,381,473,111,278,389,242,106,22,174,1236,10869
147,Georges Niang,2013,2016,69,2187,505,986,401,696,104,290,171,223,80,290,370,240,52,43,174,1285,12054
148,Gerald Brown,2006,2008,62,2055,383,918,258,558,125,360,365,474,85,218,303,141,106,18,215,1256,9595
149,Gerald Henderson,2008,2009,37,1098,213,473,172,351,41,122,143,188,46,137,183,91,46,28,80,610,10818
150,Gerald Henderson,2008,2009,37,1098,213,473,172,351,41,122,143,188,46,137,183,91,46,28,80,610,10819
151,Gian Clavell,2016,2017,27,987,193,449,115,247,78,202,88,127,37,133,170,47,53,20,53,552,9817
152,Gilbert Arenas,2000,2001,36,1044,208,434,139,268,69,166,97,134,29,102,131,84,65,7,101,582,9220
153,Glen Davis,2005,2006,36,1144,250,505,244,482,6,23,163,241,145,205,350,50,47,41,96,669,10018
154,Gordon Hayward,2009,2010,37,1239,173,373,126,213,47,160,179,216,72,233,305,62,40,30,85,572,10800
155,Greg Monroe,2009,2010,34,1164,202,385,195,358,7,27,138,209,74,254,328,128,42,52,112,549,11906
156,Greivis Vasquez,2007,2010,102,3588,637,1512,438,911,199,601,364,436,106,429,535,615,152,34,358,1837,13236
157,Guillermo Diaz,2004,2006,63,2192,384,884,245,502,139,382,217,289,48,178,226,173,83,16,137,1124,10091
158,Hakim Warrick,2003,2005,65,2431,475,896,466,859,9,37,382,557,204,356,560,132,62,62,181,1341,13327
159,Harrison Barnes,2010,2012,75,2198,438,1018,322,686,116,332,234,319,149,265,414,96,68,29,146,1226,9301
160,Hassan Adams,2005,2006,31,1031,234,490,217,425,17,65,58,95,67,88,155,90,82,14,69,543,9119
161,Henry Ellenson,2015,2016,33,1107,194,435,164,331,30,104,143,191,71,250,321,59,28,49,78,561,10239
162,Ian Clark,2012,2013,33,1102,217,400,115,178,102,222,65,78,12,96,108,79,53,8,88,601,9812
163,Ike Diogu,2002,2005,91,3190,617,1080,576,974,41,106,671,854,306,496,802,113,39,153,305,1946,10115
164,Isaiah Canaan,2011,2013,64,2243,402,899,210,430,192,469,306,369,46,178,224,253,92,6,187,1302,9713
165,Isaiah Thomas,2008,2011,105,3197,554,1301,390,796,164,505,449,630,70,296,366,415,122,7,279,1721,13079
166,Isaiah Whitehead,2015,2016,34,1098,194,512,113,290,81,222,149,196,18,104,122,173,40,49,119,618,13416
167,J.J. Barea,2003,2006,85,2860,622,1545,415,902,207,643,362,478,73,279,352,612,134,0,347,1813,9294
168,J.J. Redick,2003,2006,106,3719,676,1545,314,657,362,888,560,615,47,247,294,239,114,7,242,2274,12438
169,J.R. Bremer,2001,2002,30,1140,231,560,143,294,88,266,188,234,40,100,140,92,56,2,91,738,9547
170,J.R. Giddens,2007,2008,33,1063,210,407,185,332,25,75,92,157,57,233,290,103,47,39,73,537,10514
171,JaJuan Johnson,2009,2011,69,2296,449,899,434,844,15,55,327,429,164,377,541,59,60,151,119,1240,11122
172,Jabari Brown,2013,2014,35,1295,203,435,123,240,80,195,212,266,17,138,155,67,22,5,82,698,9597
173,Jabari Parker,2013,2014,35,1074,236,499,198,393,38,106,160,214,105,201,306,41,37,43,81,670,12205
174,Jacob Pullen,2009,2011,68,2180,392,928,208,456,184,472,373,467,36,150,186,240,116,6,188,1341,12380
175,Jacob Wiley,2016,2017,34,1165,265,412,260,405,5,7,159,192,95,214,309,80,26,94,128,694,13436
176,Jae Crowder,2011,2012,35,1153,217,436,156,259,61,177,119,162,70,224,294,73,88,35,44,614,9949
177,Jahlil Okafor,2014,2015,38,1143,279,420,279,420,0,0,99,194,134,188,322,49,29,54,95,657,12134
178,Jakob Poeltl,2015,2016,36,1093,228,353,228,353,0,0,164,238,102,225,327,70,21,56,74,620,12322
179,Jamaal Franklin,2011,2013,64,2027,338,801,247,497,91,304,331,419,113,443,556,152,82,46,205,1098,10407
180,Jamal Murray,2015,2016,36,1267,244,538,131,261,113,277,119,152,53,133,186,79,35,11,84,720,11984
181,Jameer Nelson,2002,2004,62,2133,428,937,291,561,137,376,257,329,72,232,304,312,155,7,178,1250,12034
182,Jamel Artis,2016,2017,32,1097,196,413,122,224,74,189,116,158,40,116,156,106,13,9,83,582,9237
183,James Anderson,2008,2010,68,2295,435,928,277,505,158,423,345,422,140,250,390,128,86,44,147,1373,9187
184,James Ennis,2012,2013,33,1093,182,371,127,217,55,154,126,151,65,156,221,70,58,43,99,545,10270
185,James Harden,2007,2009,69,2412,417,824,315,553,102,271,373,494,92,282,374,258,132,30,207,1309,10728
186,James Young,2013,2014,40,1296,183,450,101,215,82,235,125,177,41,130,171,67,30,8,75,573,13621
187,JamesOn Curry,2006,2007,35,1295,202,447,114,233,88,214,115,145,15,96,111,131,41,11,109,607,9966
188,Jared Cunningham,2011,2012,36,1245,198,440,148,292,50,148,199,270,36,102,138,101,91,15,102,645,9957
189,Jared Dudley,2005,2007,66,2492,393,748,321,566,72,182,313,432,187,300,487,205,83,22,148,1171,10167
190,Jared Jeffries,2001,2002,36,1175,189,414,162,343,27,71,134,201,91,182,273,74,54,46,102,539,11074
191,Jared Sullinger,2010,2012,74,2295,450,849,431,797,19,52,363,495,247,470,717,89,80,59,130,1282,12996
192,Jarell Martin,2014,2015,33,1159,202,397,188,345,14,52,140,203,98,207,305,59,38,23,92,558,11658
193,Jarnell Stokes,2013,2014,37,1199,199,375,199,375,0,0,160,230,155,237,392,75,26,34,77,558,12968
194,Jarrod Uthoff,2015,2016,33,1016,218,487,152,314,66,173,122,150,48,161,209,36,32,86,38,624,13210
195,Jarvis Hayes,2001,2002,29,980,212,470,163,320,49,150,65,85,35,117,152,45,34,14,60,538,10797
196,Jason Kapono,2000,2001,32,1122,167,379,83,195,84,184,133,153,54,129,183,72,38,4,81,551,11239
197,Jason Thompson,2006,2008,65,2234,496,916,479,860,17,56,309,472,206,518,724,158,59,158,192,1318,13105
198,Jawun Evans,2016,2017,32,936,211,482,175,387,36,95,155,191,24,86,110,204,57,4,90,613,10284
199,Jay Williams,2000,2002,74,2415,534,1148,294,557,240,591,279,418,58,194,252,424,154,8,285,1587,13483
200,Jeff Teague,2008,2009,31,991,180,371,135,269,45,102,179,219,15,87,102,110,58,20,104,584,13052
201,Jeffery Taylor,2011,2012,36,1157,210,426,144,270,66,156,95,157,77,123,200,62,46,16,79,581,13041
202,Jerel McNeal,2008,2009,35,1226,236,534,150,318,86,216,135,183,28,131,159,137,71,21,103,693,11791
203,Jeremy Lamb,2011,2012,34,1266,217,454,146,243,71,211,98,121,32,134,166,58,42,21,68,603,11408
204,Jerian Grant,2014,2015,38,1408,204,427,154,269,50,158,170,218,13,102,115,253,63,19,82,628,10584
205,Jermaine Taylor,2007,2009,62,2026,522,1107,351,647,171,460,243,302,112,196,308,110,74,33,165,1458,13042
206,Jerome Dyson,2009,2010,34,1143,195,499,155,362,40,137,156,218,33,113,146,144,44,21,132,586,10196
207,Jerome Jordan,2009,2010,35,1043,184,335,184,335,0,0,172,250,84,233,317,44,16,82,79,540,11216
208,Jerrelle Benimon,2013,2014,36,1307,225,425,211,381,14,44,209,293,84,320,404,130,25,44,124,673,9387
209,Jerryd Bayless,2007,2008,30,1072,173,378,114,233,59,145,187,223,13,69,82,121,29,3,89,592,9346
210,Jimmer Fredette,2009,2011,71,2382,571,1256,370,768,201,488,476,533,49,183,232,319,90,6,224,1819,10414
211,Jimmy Butler,2010,2011,37,1282,187,382,167,324,20,58,188,240,90,135,225,86,53,13,54,582,9678
212,Joakim Noah,2005,2006,39,972,202,322,202,321,0,1,148,202,85,193,278,80,44,95,76,552,12066
213,Jodie Meeks,2008,2009,36,1237,263,568,146,280,117,288,211,234,19,103,122,63,48,5,96,854,11806
214,Joe Alexander,2007,2008,36,1137,219,474,208,433,11,41,158,194,68,163,231,88,26,54,80,607,9147
215,Joe Crawford,2007,2008,30,1009,188,401,125,228,63,173,99,130,31,78,109,64,17,5,83,538,9926
216,Joe Crispin,2000,2001,33,1121,195,523,87,220,108,303,144,165,15,103,118,110,47,5,96,642,9931
217,Joe Harris,2012,2013,35,1139,191,408,114,227,77,181,111,150,30,111,141,76,31,17,70,570,10759
218,Joe Young,2012,2015,102,3429,656,1425,423,830,233,595,419,470,63,305,368,280,104,2,167,1964,13622
219,Joel Bolomboy,2015,2016,33,1041,193,337,173,282,20,55,159,228,109,306,415,35,23,40,78,565,9471
220,Joey Graham,2004,2005,33,1009,201,380,175,325,26,55,157,177,53,151,204,67,30,5,88,585,10567
221,John Brown,2013,2016,91,2811,678,1203,677,1191,1,12,412,561,297,333,630,161,134,133,150,1769,9599
222,John Collins,2016,2017,33,878,234,376,234,375,0,1,164,220,124,200,324,17,21,52,60,632,9850
223,John Holland,2008,2011,99,3423,603,1393,387,793,216,600,448,536,170,406,576,123,156,31,197,1870,10900
224,John Jenkins,2010,2012,67,2282,407,869,173,319,234,550,272,314,33,163,196,81,53,22,107,1320,11077
225,John Lucas,2004,2005,33,1192,204,452,104,220,100,232,76,84,19,63,82,135,36,1,53,584,11558
226,John Wall,2009,2010,37,1288,202,438,165,324,37,114,175,232,30,129,159,241,66,19,149,616,13294
227,Johnathan Motley,2016,2017,34,1036,226,434,217,401,9,33,128,183,126,209,335,79,12,37,100,589,11952
228,Jon Brockman,2007,2008,32,1009,237,442,237,442,0,0,94,181,141,229,370,35,21,8,76,568,9569
229,Jon Leuer,2010,2011,34,1139,227,483,173,337,54,146,113,134,57,189,246,56,17,30,54,621,11486
230,Jonathan Gibson,2009,2010,34,1109,197,441,91,180,106,261,95,112,17,81,98,95,47,2,73,595,10510
231,Jonny Flynn,2007,2009,73,2661,410,892,309,589,101,303,290,371,44,154,198,439,107,12,224,1211,10362
232,Jordan Adams,2013,2014,36,1082,208,429,156,283,52,146,158,189,67,125,192,84,95,5,54,626,9120
233,Jordan Clarkson,2013,2014,35,1228,209,467,177,353,32,114,162,195,28,106,134,118,38,6,93,612,9816
234,Jordan Crawford,2009,2010,35,1147,260,563,181,361,79,202,119,154,34,132,166,101,47,7,85,718,9927
235,Jordan Hamilton,2010,2011,36,1159,243,552,153,318,90,234,95,122,72,204,276,76,31,23,77,671,10695
236,Jordan Hill,2008,2009,34,1213,252,469,252,469,0,0,117,179,143,232,375,50,30,58,97,621,10871
237,Jordan McRae,2013,2014,37,1190,223,512,144,287,79,225,167,212,26,102,128,91,25,38,77,692,11799
238,Jordan Williams,2010,2011,33,1073,213,396,213,396,0,0,131,228,121,267,388,21,23,45,53,557,13487
239,Joseph Forte,2000,2001,33,1145,251,558,196,412,55,146,133,156,41,160,201,116,67,12,84,690,10383
240,Josh Akognon,2007,2009,64,2153,460,1090,208,429,252,661,239,267,36,172,208,99,76,5,139,1411,9135
241,Josh Davis,2012,2013,35,1250,207,421,206,419,1,2,202,282,143,231,374,61,28,30,92,617,10023
242,Josh Hart,2015,2017,76,2448,466,911,337,574,129,337,230,307,125,375,500,183,102,20,137,1291,10772
243,Josh Howard,2002,2003,31,1002,204,428,151,286,53,142,145,174,102,155,257,59,64,48,82,606,10944
244,Josh Jackson,2016,2017,35,1077,220,429,186,339,34,90,98,173,81,177,258,104,59,37,97,572,11021
245,Juan Dixon,2000,2002,72,2307,483,1015,329,632,154,383,269,305,95,224,319,197,187,15,175,1389,10120
246,Julius Hodge,2002,2005,96,3351,550,1147,469,895,81,252,507,664,192,421,613,383,130,72,271,1688,10887
247,Julius Randle,2013,2014,40,1233,196,391,193,373,3,18,204,289,139,277,416,57,20,31,101,599,12410
248,Justin Harper,2010,2011,37,1178,245,459,168,287,77,172,94,118,62,194,256,43,23,46,56,661,10741
249,Justin Jackson,2016,2017,40,1281,264,596,159,312,105,284,98,131,58,128,186,113,31,9,69,731,11022
250,Juwan Howard,2013,2015,65,2147,424,994,307,683,117,311,195,231,92,213,305,149,62,25,131,1160,10945
251,K.J. McDaniels,2013,2014,36,1212,209,455,167,317,42,138,154,183,86,169,255,57,41,100,83,614,11735
252,Kalin Lucas,2008,2011,72,2349,367,891,273,650,94,241,309,380,42,111,153,290,74,8,171,1137,11559
253,Kareem Rush,2000,2002,62,1945,441,1019,261,591,180,428,199,254,106,256,362,140,73,43,190,1261,12613
254,Kawhi Leonard,2010,2011,36,1172,211,475,186,389,25,86,110,145,111,269,380,91,51,21,76,557,11479
255,Kay Felder,2014,2016,68,2558,452,1046,329,693,123,353,424,506,51,256,307,576,135,15,257,1451,10318
256,Keith Benson,2009,2011,70,2228,439,812,428,784,11,28,346,505,204,517,721,66,43,242,124,1235,9398
257,Keith Bogans,2000,2003,70,2118,404,869,250,455,154,414,179,249,106,190,296,178,76,12,167,1141,9463
258,Keith Langford,2002,2003,38,1246,240,453,218,377,22,76,101,159,83,102,185,75,34,31,73,603,11422
259,Keith McLeod,2001,2002,33,1109,224,496,135,280,89,216,218,270,25,112,137,90,65,2,102,755,11780
260,Kelly Olynyk,2012,2013,32,845,215,342,206,312,9,30,132,170,77,158,235,55,22,36,77,571,12150
261,Kemba Walker,2010,2011,41,1543,316,739,241,512,75,227,258,315,53,170,223,184,77,7,93,965,13289
262,Kenneth Faried,2009,2011,70,2276,457,771,456,767,1,4,280,478,348,616,964,56,123,149,176,1195,10300
263,Kent Bazemore,2011,2012,35,1103,186,457,135,298,51,159,115,182,65,148,213,107,74,12,112,538,9351
264,Kentavious Caldwell-Pope,2012,2013,32,1086,186,430,102,205,84,225,135,169,37,189,226,58,65,17,64,591,9701
265,Kevin Durant,2006,2007,35,1255,306,647,224,444,82,203,209,256,106,284,390,46,66,67,99,903,10186
266,Kevin Jones,2011,2012,33,1265,260,511,226,383,34,128,103,132,141,219,360,41,23,34,42,657,11191
267,Kevin Love,2007,2008,39,1156,227,406,198,324,29,82,198,258,142,273,415,75,27,56,78,681,11550
268,Kevin Martin,2001,2004,79,2515,565,1224,391,721,174,503,534,635,75,279,354,133,134,30,232,1838,11661
269,Kevin Murphy,2010,2012,66,2105,441,961,325,660,116,301,243,334,48,273,321,134,62,13,215,1241,11979
270,Kirk Haston,2000,2001,33,1018,243,552,217,483,26,69,114,166,80,208,288,41,36,40,79,626,10782
271,Kirk Hinrich,2001,2003,74,2383,430,854,275,497,155,357,172,229,82,234,316,316,128,31,182,1187,10880
272,Kirk Snyder,2003,2004,34,1079,209,485,155,330,54,155,166,227,65,130,195,117,35,22,119,638,12893
273,Klay Thompson,2009,2011,65,2275,440,1036,266,581,174,455,288,351,62,275,337,197,100,54,219,1342,13108
274,Kris Dunn,2015,2016,33,1088,184,411,142,298,42,113,132,190,36,140,176,206,82,20,116,542,10182
275,Kris Humphries,2003,2004,29,990,221,498,204,448,17,50,170,229,91,203,294,20,27,33,82,629,10967
276,Kyle Collinsworth,2015,2016,37,1249,206,444,197,407,9,37,146,224,86,217,303,275,74,20,126,567,9854
277,Kyle Korver,2002,2003,34,1082,183,391,54,122,129,269,109,120,46,171,217,104,50,23,68,604,11356
278,Kyle O'Quinn,2011,2012,36,1125,205,358,199,326,6,32,156,224,114,258,372,51,25,97,95,572,12118
279,Kyle Singler,2008,2011,114,3915,655,1531,439,945,216,586,415,537,290,527,817,245,132,82,241,1941,12802
280,Kyle Wiltjer,2014,2016,74,2258,502,977,344,625,158,352,212,256,112,351,463,124,31,54,117,1374,13547
281,LaMarcus Aldridge,2005,2006,37,1247,219,385,219,385,0,0,117,181,135,204,339,20,50,73,59,555,9141
282,Lamar Patterson,2013,2014,36,1174,202,458,122,252,80,206,132,175,35,140,175,154,51,12,93,616,12225
283,Lamond Murray,2016,2017,31,1060,251,528,200,394,51,134,109,140,36,140,176,40,35,12,81,662,11986
284,Landry Fields,2009,2010,32,1161,248,506,219,420,29,86,179,257,81,199,280,89,51,25,83,704,10340
285,Langston Galloway,2013,2014,34,1231,190,428,82,184,108,244,114,138,28,117,145,53,36,17,28,602,10450
286,Lauri Markkanen,2016,2017,37,1140,185,376,116,213,69,163,137,164,88,178,266,32,15,19,40,576,11637
287,Lawrence Roberts,2004,2005,32,1023,171,382,159,341,12,41,188,288,110,241,351,61,50,26,87,542,12515
288,Lazar Hayward,2008,2010,69,2206,426,949,308,615,118,334,216,260,171,387,558,91,99,27,132,1186,10801
289,Leon Powe,2005,2006,27,953,178,359,175,350,3,9,194,270,89,184,273,38,24,15,66,553,12347
290,Lester Hudson,2007,2009,65,2372,604,1324,374,705,230,619,289,337,142,371,513,283,169,40,232,1727,10952
291,Lionel Chalmers,2003,2004,37,1293,204,454,103,207,101,247,105,148,17,105,122,117,40,1,103,614,9771
292,Lonny Baxter,2000,2001,36,935,219,387,218,385,1,2,122,206,101,185,286,19,31,55,56,561,9345
293,Luis Flores,2001,2004,90,3342,645,1432,482,1010,163,422,593,674,133,272,405,206,161,21,267,2046,10359
294,Luke Babbitt,2008,2010,68,2370,445,927,370,749,75,178,351,393,133,421,554,119,59,51,146,1316,9260
295,Luke Harangody,2007,2010,97,3111,803,1678,761,1550,42,128,469,605,303,722,1025,172,71,80,192,2117,10724
296,Luke Jackson,2001,2004,66,2141,399,843,280,562,119,281,322,373,112,299,411,254,83,17,162,1239,11023
297,Luke Jackson,2001,2004,66,2141,399,843,280,562,119,281,322,373,112,299,411,254,83,17,162,1239,11024
298,Luke Kennard,2016,2017,37,1314,237,485,149,284,88,201,160,187,43,145,188,91,31,13,59,722,11269
299,Luke Ridnour,2001,2003,68,2378,372,831,198,408,174,423,273,312,29,186,215,394,121,6,236,1191,12486
300,Luol Deng,2003,2004,37,1149,210,441,170,330,40,111,98,138,82,173,255,68,49,39,83,558,10076
301,Luther Head,2004,2005,39,1297,214,462,98,179,116,283,78,99,24,131,155,150,67,9,69,622,10806
302,Lynn Greer,2000,2002,68,2697,441,1096,265,636,176,460,336,386,53,176,229,332,127,9,184,1394,10629
303,Malcolm Brogdon,2015,2016,37,1263,230,503,155,311,75,192,140,156,19,131,150,115,35,9,52,675,9571
304,Malcolm Delaney,2008,2011,101,3738,533,1342,316,732,217,610,636,745,91,286,377,436,147,20,299,1919,10066
305,Malik Monk,2016,2017,38,1218,251,558,147,296,104,262,148,180,12,83,95,87,36,19,75,754,11904
306,Manny Harris,2008,2010,66,2272,362,866,262,551,100,315,328,394,119,305,424,280,99,29,198,1152,10761
307,Marcus Banks,2002,2003,32,1154,223,434,182,312,41,122,162,214,18,89,107,175,91,4,126,649,9287
308,Marcus Georges-Hunt,2015,2016,36,1167,178,392,138,275,40,117,205,249,32,90,122,119,31,16,73,601,10500
309,Marcus Morris,2010,2011,38,1076,240,421,214,345,26,76,148,215,99,191,290,62,32,24,67,654,11934
310,Marcus Paige,2013,2014,34,1211,191,434,105,213,86,221,128,146,18,91,109,143,51,7,73,596,12188
311,Marcus Smart,2013,2014,31,1014,163,386,114,222,49,164,182,250,44,139,183,148,89,18,82,557,12825
312,Marcus Thornton,2007,2015,161,5598,1059,2359,603,1220,456,1139,596,750,161,453,614,385,180,49,377,3170,13120
313,Markel Brown,2013,2014,34,1201,190,402,135,257,55,145,149,194,36,143,179,99,34,35,55,584,9607
314,Markelle Fultz,2016,2017,25,892,209,439,157,313,52,126,109,168,33,110,143,148,40,30,80,579,10434
315,Marquis Daniels,2002,2003,34,1187,244,476,214,378,30,98,107,159,63,147,210,113,78,8,102,625,9983
316,Mason Plumlee,2012,2013,36,1248,221,369,221,369,0,0,173,254,98,260,358,70,36,52,103,615,12318
317,Matt Carroll,2002,2003,34,1154,215,487,116,244,99,243,135,160,29,140,169,55,37,5,54,664,9739
318,Matt Freije,2003,2004,33,985,185,446,123,272,62,174,175,222,66,112,178,30,23,21,34,607,10420
319,Matt Williams,2016,2017,36,1315,178,455,52,127,126,328,60,74,16,138,154,69,25,1,65,542,13496
320,Matthew Dellavedova,2012,2013,35,1273,170,421,84,196,86,225,127,149,23,95,118,223,40,4,99,553,10070
321,Maurice Ager,2005,2006,34,1170,226,495,143,274,83,221,121,159,24,115,139,84,23,11,87,656,9128
322,Maurice Baker,2000,2001,30,1121,200,381,136,224,64,157,129,160,74,128,202,127,61,4,125,593,9276
323,Melvin Ely,2001,2002,28,999,246,437,246,436,0,1,161,219,90,164,254,50,19,88,73,653,10256
324,Michael Beasley,2007,2008,33,1041,307,577,271,482,36,95,216,279,131,277,408,38,42,54,95,866,9361
325,Michael Bradley,2000,2001,31,1053,254,367,242,333,12,34,125,212,107,196,303,81,28,56,88,645,9530
326,Michael Gbinije,2015,2016,37,1403,225,488,134,255,91,233,106,160,40,111,151,159,70,13,105,647,10491
327,Michael Young,2016,2017,33,1097,217,479,175,356,42,123,172,221,53,170,223,90,19,25,70,648,13624
328,Mike Brown,2015,2016,34,1167,188,466,144,328,44,138,159,198,75,125,200,110,52,12,108,579,9608
329,Mike Dunleavy,2001,2002,35,1133,218,451,130,218,88,233,81,119,45,206,251,72,80,26,61,605,10180
330,Mike Dunleavy,2001,2002,35,1133,218,451,130,218,88,233,81,119,45,206,251,72,80,26,61,605,10181
331,Mike Harris,2003,2005,64,2024,457,755,434,693,23,62,280,373,214,444,658,79,85,59,128,1217,10762
332,Mike James,2011,2012,32,995,211,466,172,346,39,120,87,108,30,72,102,63,50,4,66,548,11054
333,Mike James,2011,2012,32,995,211,466,172,346,39,120,87,108,30,72,102,63,50,4,66,548,11055
334,Mike Muscala,2011,2013,69,2126,420,830,409,794,11,36,382,465,195,502,697,141,33,139,130,1233,11992
335,Mike Scott,2011,2012,32,999,215,382,209,362,6,20,139,172,70,195,265,37,21,15,67,575,12703
336,Mike Smith,2010,2020,61,2172,432,956,331,678,101,278,239,302,71,269,340,184,66,15,161,1204,12869
337,Mike Sweetney,2001,2003,63,1983,449,809,449,805,0,4,430,567,240,402,642,115,75,157,161,1328,13012
338,Mike Wilks,2000,2001,30,1114,190,434,134,289,56,145,168,215,45,102,147,90,59,8,76,604,13450
339,Mike Williams,2003,2004,31,888,228,427,227,422,1,5,130,169,79,139,218,37,60,35,53,587,13498
340,Monte Morris,2016,2017,35,1237,216,465,162,322,54,143,89,111,40,129,169,217,53,10,42,575,11937
341,Montrezl Harrell,2014,2015,35,1229,213,376,204,339,9,37,114,191,111,210,321,49,33,42,69,549,10745
342,Morris Almond,2005,2007,60,1974,487,992,362,715,125,277,357,431,92,232,324,69,77,43,189,1456,9165
343,Nate Robinson,2004,2005,35,1101,188,406,126,245,62,161,136,174,53,82,135,149,61,6,71,574,12536
344,Nate Wolters,2010,2013,98,3501,693,1506,554,1097,139,409,535,671,99,401,500,583,157,13,220,2060,13571
345,Nick Calathes,2007,2009,72,2374,380,836,249,491,131,345,279,390,72,307,379,452,126,9,223,1170,9696
346,Nick Collison,2001,2003,75,2222,526,921,510,875,16,46,211,346,249,438,687,148,83,157,185,1279,9856
347,Nick Fazekas,2004,2007,97,3029,739,1388,647,1115,92,273,465,565,256,741,997,154,80,148,193,2035,10310
348,Nick Johnson,2013,2014,38,1257,205,474,143,305,62,169,146,187,31,123,154,107,43,25,64,618,11138
349,Nick Young,2006,2007,37,1227,239,455,195,355,44,100,125,159,44,127,171,50,27,10,90,647,13625
350,Nik Stauskas,2013,2014,36,1281,185,394,93,186,92,208,168,204,15,90,105,118,20,11,67,630,12937
351,Nikola Vucevic,2010,2011,34,1187,215,426,186,343,29,83,123,163,97,253,350,54,18,47,58,582,13266
352,Nolan Smith,2009,2011,75,2608,499,1110,382,794,117,316,309,389,79,193,272,303,92,12,188,1424,12870
353,Norman Powell,2014,2015,36,1244,213,467,175,348,38,119,127,169,21,148,169,75,66,16,80,591,12352
354,Norris Cole,2009,2011,69,2412,436,1000,347,740,89,260,358,430,41,260,301,337,141,6,188,1319,9835
355,O.J. Mayo,2007,2008,33,1216,237,536,149,321,88,215,122,152,35,115,150,109,51,13,117,684,11693
356,Orlando Johnson,2009,2012,93,3071,605,1292,423,849,182,443,433,588,157,382,539,254,94,56,244,1825,11140
357,P.J. Tucker,2005,2006,37,1276,225,437,223,434,2,3,142,190,105,248,353,106,66,13,115,594,13176
358,Pascal Siakam,2015,2016,34,1176,275,510,272,495,3,15,137,202,132,263,395,58,34,75,67,690,12769
359,Patricio Garino,2015,2016,38,1217,203,398,145,263,58,135,73,106,52,109,161,56,52,31,72,537,10464
360,Patrick Christopher,2009,2010,35,1209,204,457,146,285,58,172,80,93,50,140,190,71,56,3,50,546,9806
361,Patrick Patterson,2008,2010,72,2402,455,772,431,702,24,70,219,298,208,391,599,103,48,121,107,1153,12226
362,Paul Davis,2005,2006,33,1018,206,364,200,345,6,19,160,184,87,214,301,54,34,29,81,578,10032
363,Paul Graham,2008,2009,31,1071,196,503,130,306,66,197,117,141,26,94,120,62,20,3,64,575,10570
364,Paul Millsap,2004,2006,62,2187,483,843,478,828,5,15,270,442,353,445,798,65,95,131,157,1241,11871
365,Pierre Jackson,2012,2013,36,1252,216,506,128,261,88,245,192,240,24,111,135,255,54,0,122,712,11032
366,Predrag Savovic,2000,2001,31,1006,189,418,128,247,61,171,106,143,45,102,147,107,39,2,96,545,12661
367,Quincy Douby,2005,2006,33,1211,287,621,171,332,116,289,149,176,27,114,141,103,58,27,92,839,10136
368,Quincy Pondexter,2009,2010,36,1162,245,464,227,413,18,51,187,226,107,158,265,63,46,21,68,695,12329
369,Quinn Cook,2014,2015,39,1396,199,439,97,181,102,258,98,110,15,116,131,103,39,1,47,598,9885
370,Quinton Ross,2002,2003,30,1056,191,422,149,281,42,141,184,232,77,114,191,63,46,24,64,608,12579
371,R.J. Hunter,2013,2015,68,2400,384,922,204,407,180,515,344,391,38,278,316,183,138,66,116,1292,10975
372,Rafael Araujo,2003,2004,30,895,211,368,203,338,8,30,122,169,87,216,303,37,43,25,87,552,9214
373,Rakeem Christmas,2014,2015,31,1064,203,368,203,367,0,1,136,191,97,185,282,47,29,78,78,542,9804
374,Randolph Morris,2006,2007,34,937,202,341,202,341,0,0,142,208,67,197,264,37,26,70,74,546,11938
375,Randy Foye,2005,2006,33,1145,226,550,137,296,89,254,136,172,54,136,190,100,46,21,71,677,10401
376,Randy Holcomb,2001,2002,33,1067,220,426,208,386,12,40,106,167,88,208,296,57,24,32,116,558,10895
377,Rashad McCants,2002,2004,65,2007,431,889,281,524,150,365,181,251,120,179,299,116,102,39,157,1193,11704
378,Rasual Butler,2000,2002,61,2366,464,1111,310,681,154,430,229,269,126,293,419,101,75,63,177,1311,9681
379,Rawle Marshall,2004,2005,32,1157,210,477,171,345,39,132,177,242,85,161,246,70,59,40,102,636,11646
380,Ray McCallum,2011,2013,69,2421,406,855,334,600,72,255,288,389,80,250,330,290,121,27,148,1172,11700
381,Reece Gaines,2001,2003,64,2079,386,841,220,408,166,433,309,402,43,175,218,273,99,15,165,1247,10444
382,Reggie Jackson,2010,2011,34,1161,219,435,148,266,71,169,109,137,35,111,146,152,36,18,81,618,11035
383,Reggie Johnson,2015,2016,32,1153,192,519,138,334,54,185,140,194,39,77,116,129,53,3,90,578,11142
384,Reggie Williams,2006,2008,58,1948,607,1145,488,753,119,392,290,437,203,302,505,243,110,27,174,1623,13505
385,Reggie Williams,2006,2008,58,1948,607,1145,488,753,119,392,290,437,203,302,505,243,110,27,174,1623,13506
386,Robbie Hummel,2011,2012,35,1128,194,465,122,277,72,188,113,137,55,196,251,66,23,42,32,573,10963
387,Robert Covington,2011,2012,33,1028,212,403,147,258,65,145,100,129,95,165,260,43,51,45,77,589,9916
388,Robert Hite,2005,2006,34,1127,201,446,116,239,85,207,71,87,46,152,198,48,50,10,55,558,10884
389,Rodney Carney,2004,2006,75,2158,431,1024,253,529,178,495,203,273,120,228,348,91,88,53,109,1243,9727
390,Rodney Hood,2013,2014,35,1150,191,412,120,243,71,169,109,135,29,109,138,75,25,9,54,562,10917
391,Rodney McGruder,2012,2013,35,1171,204,462,153,310,51,152,88,117,74,114,188,71,44,9,58,547,11756
392,Rodney Stuckey,2005,2007,59,1955,477,1011,379,702,98,309,386,479,67,212,279,283,137,17,205,1438,12992
393,Ronald Dupree,2001,2002,34,1203,220,487,189,379,31,108,81,145,94,196,290,73,35,22,107,552,10185
394,Ronnie Brewer,2005,2006,32,1112,197,447,146,296,51,151,144,192,39,115,154,104,83,15,70,589,9555
395,Russ Smith,2012,2014,77,2295,457,1041,325,671,132,370,375,493,70,184,254,288,157,6,213,1421,12877
396,Ryan Anderson,2006,2008,66,2178,419,866,297,558,122,308,276,328,179,418,597,63,34,36,121,1236,9197
397,Ryan Gomes,2002,2005,92,3321,652,1274,571,1047,81,227,421,509,301,539,840,233,148,34,230,1806,10544
398,Ryan Humphrey,2001,2002,31,1103,231,472,228,466,3,6,122,204,115,222,337,80,33,87,77,587,10965
399,Salim Stoudamire,2004,2005,36,1126,210,417,90,179,120,238,122,134,9,74,83,78,30,4,85,662,12977
400,Sam Dekker,2014,2015,40,1239,213,406,163,255,50,151,80,113,77,143,220,49,21,18,36,556,10064
401,Sam Young,2007,2009,73,2333,515,1025,417,765,98,260,230,322,152,305,457,85,76,72,175,1358,13627
402,Scotty Hopson,2010,2011,32,937,188,416,135,275,53,141,114,155,28,79,107,41,26,5,89,543,10924
403,Sean Kilpatrick,2012,2014,68,2318,408,994,233,460,175,534,287,358,81,241,322,149,90,9,137,1278,11294
404,Sean Lampley,2000,2001,31,1073,209,416,202,383,7,33,180,244,46,178,224,102,29,14,112,605,11413
405,Sean May,2004,2005,37,992,228,402,228,399,0,3,191,252,142,255,397,62,43,38,94,647,11686
406,Sean Singletary,2006,2008,65,2186,373,901,236,540,137,361,379,440,62,212,274,353,98,2,228,1262,12803
407,Semaj Christon,2013,2014,34,1200,201,420,182,371,19,49,157,235,15,76,91,142,45,8,89,578,9805
408,Semi Ojeleye,2016,2017,35,1195,210,431,137,259,73,172,172,219,80,160,240,53,15,14,50,665,12132
409,Seth Curry,2008,2013,70,2407,440,1007,243,496,197,511,242,295,44,198,242,133,78,15,121,1319,9968
410,Shabazz Muhammad,2012,2013,32,987,202,456,162,350,40,106,128,180,87,80,167,27,23,4,51,572,11961
411,Shabazz Napier,2013,2014,40,1404,213,496,126,281,87,215,207,238,38,196,234,195,73,13,114,720,12012
412,Shane Battier,2000,2001,39,1363,251,533,127,237,124,296,152,191,94,191,285,72,82,88,60,778,9337
413,Shannon Brown,2005,2006,34,1196,202,433,138,269,64,164,117,141,38,112,150,93,50,5,85,585,9616
414,Shawn Long,2013,2016,102,2992,676,1279,597,1057,79,222,400,595,361,749,1110,116,69,208,242,1831,11537
415,Shelden Williams,2005,2006,36,1198,237,410,235,404,2,6,201,270,117,267,384,39,60,137,89,677,13516
416,Shelvin Mack,2010,2011,38,1219,201,493,114,247,87,246,120,156,27,143,170,131,30,3,93,609,11585
417,Sherron Collins,2008,2010,71,2416,411,955,264,561,147,394,250,304,27,149,176,335,78,2,200,1219,9852
418,Sindarius Thornwell,2016,2017,31,1051,195,439,137,291,58,148,215,259,77,144,221,86,66,30,76,663,13121
419,Stephen Curry,2006,2009,104,3387,871,1866,457,862,414,1004,479,547,81,392,473,388,221,28,314,2635,9969
420,Steve Burtt,2004,2006,62,2234,444,1016,268,579,176,437,313,376,33,194,227,151,60,4,176,1377,9670
421,Steve Novak,2005,2006,31,1047,173,363,52,104,121,259,74,76,34,149,183,39,18,4,32,541,12087
422,Steven Smith,2004,2006,57,2162,414,909,354,716,60,193,251,317,144,322,466,129,79,46,222,1139,12881
423,T.J. Warren,2013,2014,35,1238,342,652,311,536,31,116,156,226,113,137,250,40,63,21,83,871,13324
424,Tamar Slay,2001,2002,30,1031,196,439,116,248,80,191,95,130,38,123,161,72,49,16,89,567,12819
425,Tarence Kinsey,2005,2006,38,1321,209,461,138,272,71,189,113,134,54,120,174,88,61,13,78,602,11316
426,Tayshaun Prince,2000,2002,66,2184,413,859,284,489,129,370,180,233,123,300,423,151,58,80,122,1135,12371
427,Terrence Jones,2010,2011,38,1196,206,466,180,387,26,79,157,243,92,244,336,60,43,72,75,595,11206
428,Terrence Ross,2011,2012,35,1088,215,470,143,276,72,194,72,94,48,177,225,49,44,33,70,574,12580
429,Terry Rozier,2014,2015,36,1260,214,521,166,364,48,157,139,176,43,157,200,108,72,6,79,615,12597
430,Theron Smith,2001,2002,35,1156,233,454,188,335,45,119,176,237,120,261,381,48,39,22,93,687,12883
431,Thomas Gardner,2005,2006,28,957,186,434,92,197,94,237,85,118,31,59,90,45,27,0,92,551,10461
432,Thomas Robinson,2011,2012,39,1242,261,517,254,503,7,14,163,239,113,350,463,72,42,34,104,692,12541
433,Tierre Brown,2000,2001,31,1064,213,518,162,366,51,152,146,184,64,113,177,111,57,5,98,623,9619
434,Tim Frazier,2011,2012,32,1188,208,497,181,411,27,86,159,201,44,106,150,198,76,7,117,602,10410
435,Tim Hardaway,2012,2013,38,1324,201,460,128,265,73,195,77,111,9,168,177,93,26,17,71,552,10726
436,Tim Hardaway,2012,2013,38,1324,201,460,128,265,73,195,77,111,9,168,177,93,26,17,71,552,10727
437,Tim Kempton,2016,2017,32,1012,231,422,208,366,23,56,168,221,62,271,333,36,29,41,99,653,11267
438,Toney Douglas,2008,2009,35,1279,239,536,154,315,85,221,188,232,28,109,137,102,63,15,87,751,10141
439,Tony Allen,2003,2004,35,1107,204,405,182,331,22,74,131,194,63,130,193,109,72,30,98,561,9160
440,Tony Mitchell,2010,2011,37,1167,228,437,197,339,31,98,77,117,97,164,261,49,59,41,64,564,11887
441,Tony Mitchell,2010,2011,37,1167,228,437,197,339,31,98,77,117,97,164,261,49,59,41,64,564,11888
442,Tony Wroten,2011,2012,35,1062,198,447,189,391,9,56,154,264,80,96,176,130,66,13,132,559,13610
443,Torrey Craig,2011,2014,101,3145,592,1400,363,715,229,685,284,424,209,519,728,192,109,90,264,1697,9922
444,Travis Diener,2003,2004,31,1060,179,424,89,224,90,200,136,154,21,76,97,187,41,0,74,584,10100
445,Travis Hansen,2002,2003,32,1025,169,383,133,277,36,106,163,204,53,99,152,77,29,20,84,537,10721
446,Trenton Hassell,2000,2001,32,1213,246,507,193,371,53,136,148,186,82,167,249,144,39,15,121,693,10778
447,Treveon Graham,2012,2014,71,1984,371,836,261,522,110,314,245,344,168,286,454,126,64,11,119,1097,10572
448,Trey Burke,2012,2013,39,1378,259,560,183,362,76,198,133,166,21,103,124,260,62,20,86,727,9654
449,Trey Gilder,2007,2008,33,887,189,394,172,324,17,70,147,192,76,128,204,63,39,22,89,542,10515
450,Trey Johnson,2005,2007,67,2437,566,1312,420,923,146,389,420,563,98,215,313,163,78,5,213,1698,11149
451,Trey Thompkins,2009,2010,31,962,207,429,184,368,23,61,112,147,65,193,258,60,30,36,91,549,13095
452,Tristan Thompson,2010,2011,33,1056,158,344,92,186,66,158,211,253,16,89,105,59,24,4,74,593,13114
453,Troy Bell,2000,2003,95,3492,617,1421,376,762,241,659,649,753,171,239,410,371,225,27,249,2124,9379
454,Troy Murphy,2000,2001,30,1090,223,473,193,387,30,86,177,231,94,183,277,62,27,50,90,653,11982
455,Ty Lawson,2008,2009,35,1048,182,342,131,234,51,108,166,208,23,81,104,230,75,5,66,581,11446
456,Tyler Cavanaugh,2015,2017,73,2283,409,860,289,569,120,291,340,406,163,420,583,117,40,24,172,1278,9766
457,Tyler Dorsey,2016,2017,39,1169,189,405,101,197,88,208,105,139,33,102,135,67,30,4,59,571,10134
458,Tyler Hansbrough,2005,2009,142,4394,939,1752,927,1714,12,38,982,1241,482,737,1219,154,180,66,297,2872,10717
459,Tyler Johnson,2013,2014,35,1177,196,409,139,277,57,132,107,133,56,200,256,103,36,13,47,556,11150
460,Tyler Ulis,2015,2016,35,1288,192,442,137,282,55,160,167,195,19,86,105,246,51,4,69,606,13206
461,Tyler Zeller,2010,2012,75,2111,431,782,431,782,0,0,342,436,253,380,633,59,61,103,123,1204,13638
462,Tyreke Evans,2008,2009,37,1072,230,505,196,381,34,124,138,194,47,151,198,143,77,29,133,632,10289
463,Tyshawn Taylor,2011,2012,39,1303,226,474,168,322,58,152,137,199,8,83,91,186,52,6,138,647,13049
464,Vincent Yarbrough,2001,2002,31,1097,194,457,134,290,60,167,112,163,70,164,234,87,58,25,93,560,13614
465,Wayne Ellington,2007,2009,77,2369,452,952,289,553,163,399,182,227,98,262,360,179,80,13,128,1249,10240
466,Wayne Simien,2003,2004,32,1045,200,376,198,365,2,11,167,206,98,199,297,39,28,30,71,569,12782
467,Wesley Matthews,2008,2009,35,1191,193,406,151,292,42,114,213,257,46,155,201,86,43,18,82,641,11678
468,Wesley Person,2016,2018,70,2283,338,794,147,303,191,491,263,321,41,151,192,117,45,3,110,1130,12276
469,Will Barton,2011,2012,35,1236,230,452,193,345,37,107,134,179,70,209,279,102,50,25,75,631,9326
470,Will Solomon,2000,2001,30,998,183,461,88,209,95,252,130,165,17,69,86,102,42,9,123,591,12899
471,Willie Green,2002,2003,30,1021,244,498,207,399,37,99,153,190,32,116,148,75,40,13,68,678,10623
472,Xavier Munford,2013,2014,32,1139,184,458,122,268,62,190,111,157,20,108,128,78,36,13,88,541,11968
473,Xavier Silas,2010,2011,26,831,178,388,126,262,52,126,171,201,21,98,119,48,31,7,103,579,12779
474,Yogi Ferrell,2013,2016,101,3484,546,1249,297,644,249,605,373,446,64,274,338,486,86,3,237,1714,10333
475,Zabian Dowdell,2006,2007,34,1148,197,426,153,312,44,114,154,191,27,95,122,106,71,7,67,592,10145
